1111111111111111111111
1000000P00000000000001
110001100001110000C001
100000000C000000100001
1111100001111111100001
1000C00100001111000111
1011111000011111000001
111111110000E1111100C1
1111111111111111111111
