11111
10001
10C0001
10P01
11111